111111111111
100000000001
101000000001
101000001001
101000001001
101000001001
100010000001
100010000001
100010001001
100000001001
100000001001
111111111111
