111111111111
100000000001
101111000001
101000001001
101111111001
101000001001
100010000001
100011110011
100010001001
111110001001
100000001001
111111111111
